{
    "terrainLines":  [
        "##############################",
        "#     .      ###     :::::   #",
        "#    .      ###              #",
        "#    .      ###    I         #",
        "#                      ::::: #",
        "#    ##########              #",
        "#                #####       #",
        "#    I     I   :::::::       #",
        "#                            #",
        "#          I    #######      #",
        "#              #######       #",
        "#               #####        #",
        "#                ###         #",
        "#                            #",
        "##############################"
    ],
    "items": [        
        { "key": "longsword", "x": 3, "y": 3 },
        { "key": "chainmail", "x": 5, "y": 6 },
        { "key": "health_potion", "x": 10, "y": 7 },
        { "key": "grenade", "x": 15, "y": 20 }
    ]
}